####################
#p#                #
# # #### ######### #
# #   #   #      # #
# # # # # # # ## # #
# ### # # # ###### #
#     # # #        #
# ##### # ##########
# #     #          #
# # ############## #
# #     #          #
# ### ######## #####
# #          # #   #
### # # #### # # ###
#   # # # #  # #   #
# ### # # #### ### #
# #   # #          #
# ##################
#                 o#
####################
