####################
#p#                #
# # ### ########## #
# #   #   #      # #
# # # # # # # ## # #
# ### # # # ###### #
#     # # #        #
# ##### # ##########
# #     #          #
# # ############## #
# #     #          #
# ##### ###### #####
# #     #    # #   #
### ### # ## # # ###
#   # # # #  # #   #
# ### # # #### ### #
# #     #          #
# ##################
#                 o#
####################
